JavaScript/Reference/Global_Objects/Array	Array
JavaScript/Reference/Global_Objects/Array/Array	Array
JavaScript/Reference/Global_Objects/Array/Reduce	reduce
JavaScript/Reference/Global_Objects/Array/ReduceRight	reduceRight
JavaScript/Reference/Global_Objects/Array/concat	concat
JavaScript/Reference/Global_Objects/Array/constructor	constructor
JavaScript/Reference/Global_Objects/Array/every	every
JavaScript/Reference/Global_Objects/Array/filter	filter
JavaScript/Reference/Global_Objects/Array/forEach	forEach
JavaScript/Reference/Global_Objects/Array/index	index
JavaScript/Reference/Global_Objects/Array/indexOf	indexOf
JavaScript/Reference/Global_Objects/Array/input	input
JavaScript/Reference/Global_Objects/Array/isArray	isArray
JavaScript/Reference/Global_Objects/Array/join	join
JavaScript/Reference/Global_Objects/Array/lastIndexOf	lastIndexOf
JavaScript/Reference/Global_Objects/Array/length	length
JavaScript/Reference/Global_Objects/Array/map	map
JavaScript/Reference/Global_Objects/Array/pop	pop
JavaScript/Reference/Global_Objects/Array/prototype	prototype
JavaScript/Reference/Global_Objects/Array/push	push
JavaScript/Reference/Global_Objects/Array/reverse	reverse
JavaScript/Reference/Global_Objects/Array/shift	shift
JavaScript/Reference/Global_Objects/Array/slice	slice
JavaScript/Reference/Global_Objects/Array/some	some
JavaScript/Reference/Global_Objects/Array/sort	sort
JavaScript/Reference/Global_Objects/Array/splice	splice
JavaScript/Reference/Global_Objects/Array/toSource	toSource
JavaScript/Reference/Global_Objects/Array/toString	toString
JavaScript/Reference/Global_Objects/Array/unshift	unshift
JavaScript/Reference/Global_Objects/Boolean	Boolean
JavaScript/Reference/Global_Objects/Boolean/constructor	constructor
JavaScript/Reference/Global_Objects/Boolean/prototype	prototype
JavaScript/Reference/Global_Objects/Boolean/toSource	toSource
JavaScript/Reference/Global_Objects/Boolean/toString	toString
JavaScript/Reference/Global_Objects/Boolean/valueOf	valueOf
JavaScript/Reference/Global_Objects/Date	Date
JavaScript/Reference/Global_Objects/Date/UTC	UTC
JavaScript/Reference/Global_Objects/Date/constructor	constructor
JavaScript/Reference/Global_Objects/Date/getDate	getDate
JavaScript/Reference/Global_Objects/Date/getDay	getDay
JavaScript/Reference/Global_Objects/Date/getFullYear	getFullYear
JavaScript/Reference/Global_Objects/Date/getHours	getHours
JavaScript/Reference/Global_Objects/Date/getMilliseconds	getMilliseconds
JavaScript/Reference/Global_Objects/Date/getMinutes	getMinutes
JavaScript/Reference/Global_Objects/Date/getMonth	getMonth
JavaScript/Reference/Global_Objects/Date/getSeconds	getSeconds
JavaScript/Reference/Global_Objects/Date/getTime	getTime
JavaScript/Reference/Global_Objects/Date/getTimezoneOffset	getTimezoneOffset
JavaScript/Reference/Global_Objects/Date/getUTCDate	getUTCDate
JavaScript/Reference/Global_Objects/Date/getUTCDay	getUTCDay
JavaScript/Reference/Global_Objects/Date/getUTCFullYear	getUTCFullYear
JavaScript/Reference/Global_Objects/Date/getUTCHours	getUTCHours
JavaScript/Reference/Global_Objects/Date/getUTCMilliseconds	getUTCMilliseconds
JavaScript/Reference/Global_Objects/Date/getUTCMinutes	getUTCMinutes
JavaScript/Reference/Global_Objects/Date/getUTCMonth	getUTCMonth
JavaScript/Reference/Global_Objects/Date/getUTCSeconds	getUTCSeconds
JavaScript/Reference/Global_Objects/Date/getYear	getYear
JavaScript/Reference/Global_Objects/Date/now	now
JavaScript/Reference/Global_Objects/Date/parse	parse
JavaScript/Reference/Global_Objects/Date/prototype	prototype
JavaScript/Reference/Global_Objects/Date/setDate	setDate
JavaScript/Reference/Global_Objects/Date/setFullYear	setFullYear
JavaScript/Reference/Global_Objects/Date/setHours	setHours
JavaScript/Reference/Global_Objects/Date/setMilliseconds	setMilliseconds
JavaScript/Reference/Global_Objects/Date/setMinutes	setMinutes
JavaScript/Reference/Global_Objects/Date/setMonth	setMonth
JavaScript/Reference/Global_Objects/Date/setSeconds	setSeconds
JavaScript/Reference/Global_Objects/Date/setTime	setTime
JavaScript/Reference/Global_Objects/Date/setUTCDate	setUTCDate
JavaScript/Reference/Global_Objects/Date/setUTCFullYear	setUTCFullYear
JavaScript/Reference/Global_Objects/Date/setUTCHours	setUTCHours
JavaScript/Reference/Global_Objects/Date/setUTCMilliseconds	setUTCMilliseconds
JavaScript/Reference/Global_Objects/Date/setUTCMinutes	setUTCMinutes
JavaScript/Reference/Global_Objects/Date/setUTCMonth	setUTCMonth
JavaScript/Reference/Global_Objects/Date/setUTCSeconds	setUTCSeconds
JavaScript/Reference/Global_Objects/Date/setYear	setYear
JavaScript/Reference/Global_Objects/Date/toDateString	toDateString
JavaScript/Reference/Global_Objects/Date/toGMTString	toGMTString
JavaScript/Reference/Global_Objects/Date/toJSON	toJSON
JavaScript/Reference/Global_Objects/Date/toLocaleDateString	toLocaleDateString
JavaScript/Reference/Global_Objects/Date/toLocaleFormat	toLocaleFormat
JavaScript/Reference/Global_Objects/Date/toLocaleString	toLocaleString
JavaScript/Reference/Global_Objects/Date/toLocaleTimeString	toLocaleTimeString
JavaScript/Reference/Global_Objects/Date/toSource	toSource
JavaScript/Reference/Global_Objects/Date/toString	toString
JavaScript/Reference/Global_Objects/Date/toTimeString	toTimeString
JavaScript/Reference/Global_Objects/Date/toUTCString	toUTCString
JavaScript/Reference/Global_Objects/Date/valueOf	valueOf
JavaScript/Reference/Global_Objects/Error	Error
JavaScript/Reference/Global_Objects/Error/Stack	stack
JavaScript/Reference/Global_Objects/Error/constructor	constructor
JavaScript/Reference/Global_Objects/Error/message	message
JavaScript/Reference/Global_Objects/Error/name	name
JavaScript/Reference/Global_Objects/Error/prototype	prototype
JavaScript/Reference/Global_Objects/Error/toSource	toSource
JavaScript/Reference/Global_Objects/Error/toString	toString
JavaScript/Reference/Global_Objects/EvalError	EvalError
JavaScript/Reference/Global_Objects/EvalError/constructor	constructor
JavaScript/Reference/Global_Objects/EvalError/name	name
JavaScript/Reference/Global_Objects/EvalError/prototype	prototype
JavaScript/Reference/Global_Objects/Function	Function
JavaScript/Reference/Global_Objects/Function/apply	apply
JavaScript/Reference/Global_Objects/Function/arguments	arguments
JavaScript/Reference/Global_Objects/Function/arity	arity
JavaScript/Reference/Global_Objects/Function/bind	bind
JavaScript/Reference/Global_Objects/Function/call	call
JavaScript/Reference/Global_Objects/Function/caller	caller
JavaScript/Reference/Global_Objects/Function/constructor	constructor
JavaScript/Reference/Global_Objects/Function/length	length
JavaScript/Reference/Global_Objects/Function/name	name
JavaScript/Reference/Global_Objects/Function/prototype	prototype
JavaScript/Reference/Global_Objects/Function/toSource	toSource
JavaScript/Reference/Global_Objects/Function/toString	toString
JavaScript/Reference/Global_Objects/Function/valueOf	valueOf
JavaScript/Reference/Global_Objects/Infinity	Infinity
JavaScript/Reference/Global_Objects/Math	Math
JavaScript/Reference/Global_Objects/Math/E	E
JavaScript/Reference/Global_Objects/Math/LN10	LN10
JavaScript/Reference/Global_Objects/Math/LN2	LN2
JavaScript/Reference/Global_Objects/Math/LOG10E	LOG10E
JavaScript/Reference/Global_Objects/Math/LOG2E	LOG2E
JavaScript/Reference/Global_Objects/Math/PI	PI
JavaScript/Reference/Global_Objects/Math/SQRT1_2	SQRT1_2
JavaScript/Reference/Global_Objects/Math/SQRT2	SQRT2
JavaScript/Reference/Global_Objects/Math/abs	abs
JavaScript/Reference/Global_Objects/Math/acos	acos
JavaScript/Reference/Global_Objects/Math/asin	asin
JavaScript/Reference/Global_Objects/Math/atan	atan
JavaScript/Reference/Global_Objects/Math/atan2	atan2
JavaScript/Reference/Global_Objects/Math/ceil	ceil
JavaScript/Reference/Global_Objects/Math/cos	cos
JavaScript/Reference/Global_Objects/Math/exp	exp
JavaScript/Reference/Global_Objects/Math/floor	floor
JavaScript/Reference/Global_Objects/Math/log	log
JavaScript/Reference/Global_Objects/Math/max	max
JavaScript/Reference/Global_Objects/Math/min	min
JavaScript/Reference/Global_Objects/Math/pow	pow
JavaScript/Reference/Global_Objects/Math/random	random
JavaScript/Reference/Global_Objects/Math/round	round
JavaScript/Reference/Global_Objects/Math/sin	sin
JavaScript/Reference/Global_Objects/Math/sqrt	sqrt
JavaScript/Reference/Global_Objects/Math/tan	tan
JavaScript/Reference/Global_Objects/NaN	NaN
JavaScript/Reference/Global_Objects/Number	Number
JavaScript/Reference/Global_Objects/Number/MAX_VALUE	MAX_VALUE
JavaScript/Reference/Global_Objects/Number/MIN_VALUE	MIN_VALUE
JavaScript/Reference/Global_Objects/Number/NEGATIVE_INFINITY	NEGATIVE_INFINITY
JavaScript/Reference/Global_Objects/Number/NaN	NaN
JavaScript/Reference/Global_Objects/Number/POSITIVE_INFINITY	POSITIVE_INFINITY
JavaScript/Reference/Global_Objects/Number/ToLocaleString	toLocaleString
JavaScript/Reference/Global_Objects/Number/constructor	constructor
JavaScript/Reference/Global_Objects/Number/prototype	prototype
JavaScript/Reference/Global_Objects/Number/toExponential	toExponential
JavaScript/Reference/Global_Objects/Number/toFixed	toFixed
JavaScript/Reference/Global_Objects/Number/toPrecision	toPrecision
JavaScript/Reference/Global_Objects/Number/toSource	toSource
JavaScript/Reference/Global_Objects/Number/toString	toString
JavaScript/Reference/Global_Objects/Number/valueOf	valueOf
JavaScript/Reference/Global_Objects/Object	Object
JavaScript/Reference/Global_Objects/Object/GetPrototypeOf	getPrototypeOf
JavaScript/Reference/Global_Objects/Object/Parent	__parent__
JavaScript/Reference/Global_Objects/Object/Temp	Temp
JavaScript/Reference/Global_Objects/Object/constructor	constructor
JavaScript/Reference/Global_Objects/Object/create	create
JavaScript/Reference/Global_Objects/Object/defineGetter	__defineGetter__
JavaScript/Reference/Global_Objects/Object/defineProperties	defineProperties
JavaScript/Reference/Global_Objects/Object/defineProperty	defineProperty
JavaScript/Reference/Global_Objects/Object/defineSetter	__defineSetter__
JavaScript/Reference/Global_Objects/Object/eval	eval
JavaScript/Reference/Global_Objects/Object/freeze	freeze
JavaScript/Reference/Global_Objects/Object/getOwnPropertyDescriptor	getOwnPropertyDescriptor
JavaScript/Reference/Global_Objects/Object/getOwnPropertyNames	getOwnPropertyNames
JavaScript/Reference/Global_Objects/Object/hasOwnProperty	hasOwnProperty
JavaScript/Reference/Global_Objects/Object/isExtensible	isExtensible
JavaScript/Reference/Global_Objects/Object/isFrozen	isFrozen
JavaScript/Reference/Global_Objects/Object/isPrototypeOf	isPrototypeOf
JavaScript/Reference/Global_Objects/Object/isSealed	isSealed
JavaScript/Reference/Global_Objects/Object/keys	keys
JavaScript/Reference/Global_Objects/Object/lookupGetter	__lookupGetter__
JavaScript/Reference/Global_Objects/Object/lookupSetter	__lookupSetter__
JavaScript/Reference/Global_Objects/Object/noSuchMethod	__noSuchMethod__
JavaScript/Reference/Global_Objects/Object/preventExtensions	preventExtensions
JavaScript/Reference/Global_Objects/Object/propertyIsEnumerable	propertyIsEnumerable
JavaScript/Reference/Global_Objects/Object/proto	__proto__
JavaScript/Reference/Global_Objects/Object/prototype	prototype
JavaScript/Reference/Global_Objects/Object/seal	seal
JavaScript/Reference/Global_Objects/Object/toLocaleString	toLocaleString
JavaScript/Reference/Global_Objects/Object/toSource	toSource
JavaScript/Reference/Global_Objects/Object/toString	toString
JavaScript/Reference/Global_Objects/Object/unwatch	unwatch
JavaScript/Reference/Global_Objects/Object/valueOf	valueOf
JavaScript/Reference/Global_Objects/Object/watch	watch
JavaScript/Reference/Global_Objects/Proxy	Proxy
JavaScript/Reference/Global_Objects/Range	Range
JavaScript/Reference/Global_Objects/RangeError	RangeError
JavaScript/Reference/Global_Objects/RangeError/constructor	constructor
JavaScript/Reference/Global_Objects/RangeError/name	name
JavaScript/Reference/Global_Objects/RangeError/prototype	prototype
JavaScript/Reference/Global_Objects/ReferenceError	ReferenceError
JavaScript/Reference/Global_Objects/ReferenceError/constructor	constructor
JavaScript/Reference/Global_Objects/ReferenceError/name	name
JavaScript/Reference/Global_Objects/ReferenceError/prototype	prototype
JavaScript/Reference/Global_Objects/RegExp	RegExp
JavaScript/Reference/Global_Objects/RegExp/constructor	constructor
JavaScript/Reference/Global_Objects/RegExp/exec	exec
JavaScript/Reference/Global_Objects/RegExp/global	global
JavaScript/Reference/Global_Objects/RegExp/ignoreCase	ignoreCase
JavaScript/Reference/Global_Objects/RegExp/lastIndex	lastIndex
JavaScript/Reference/Global_Objects/RegExp/multiline	multiline
JavaScript/Reference/Global_Objects/RegExp/prototype	RegExp.prototype
JavaScript/Reference/Global_Objects/RegExp/source	source
JavaScript/Reference/Global_Objects/RegExp/test	test
JavaScript/Reference/Global_Objects/RegExp/toSource	toSource
JavaScript/Reference/Global_Objects/RegExp/toString	toString
JavaScript/Reference/Global_Objects/String	String
JavaScript/Reference/Global_Objects/String/String	String
JavaScript/Reference/Global_Objects/String/Trim	trim
JavaScript/Reference/Global_Objects/String/TrimLeft	trimLeft
JavaScript/Reference/Global_Objects/String/TrimRight	trimRight
JavaScript/Reference/Global_Objects/String/anchor	anchor
JavaScript/Reference/Global_Objects/String/big	big
JavaScript/Reference/Global_Objects/String/blink	blink
JavaScript/Reference/Global_Objects/String/bold	bold
JavaScript/Reference/Global_Objects/String/charAt	charAt
JavaScript/Reference/Global_Objects/String/charCodeAt	charCodeAt
JavaScript/Reference/Global_Objects/String/concat	concat
JavaScript/Reference/Global_Objects/String/constructor	constructor
JavaScript/Reference/Global_Objects/String/fixed	fixed
JavaScript/Reference/Global_Objects/String/fontcolor	fontcolor
JavaScript/Reference/Global_Objects/String/fontsize	fontsize
JavaScript/Reference/Global_Objects/String/fromCharCode	fromCharCode
JavaScript/Reference/Global_Objects/String/indexOf	indexOf
JavaScript/Reference/Global_Objects/String/italics	italics
JavaScript/Reference/Global_Objects/String/lastIndexOf	lastIndexOf
JavaScript/Reference/Global_Objects/String/length	length
JavaScript/Reference/Global_Objects/String/link	link
JavaScript/Reference/Global_Objects/String/localeCompare	localeCompare
JavaScript/Reference/Global_Objects/String/match	match
JavaScript/Reference/Global_Objects/String/prototype	prototype
JavaScript/Reference/Global_Objects/String/quote	quote
JavaScript/Reference/Global_Objects/String/replace	replace
JavaScript/Reference/Global_Objects/String/search	search
JavaScript/Reference/Global_Objects/String/slice	slice
JavaScript/Reference/Global_Objects/String/small	small
JavaScript/Reference/Global_Objects/String/split	split
JavaScript/Reference/Global_Objects/String/strike	strike
JavaScript/Reference/Global_Objects/String/sub	sub
JavaScript/Reference/Global_Objects/String/substr	substr
JavaScript/Reference/Global_Objects/String/substring	substring
JavaScript/Reference/Global_Objects/String/sup	sup
JavaScript/Reference/Global_Objects/String/toLocaleLowerCase	toLocaleLowerCase
JavaScript/Reference/Global_Objects/String/toLocaleUpperCase	toLocaleUpperCase
JavaScript/Reference/Global_Objects/String/toLowerCase	toLowerCase
JavaScript/Reference/Global_Objects/String/toSource	toSource
JavaScript/Reference/Global_Objects/String/toString	toString
JavaScript/Reference/Global_Objects/String/toUpperCase	toUpperCase
JavaScript/Reference/Global_Objects/String/valueOf	valueOf
JavaScript/Reference/Global_Objects/SyntaxError	SyntaxError
JavaScript/Reference/Global_Objects/SyntaxError/constructor	constructor
JavaScript/Reference/Global_Objects/SyntaxError/name	name
JavaScript/Reference/Global_Objects/SyntaxError/prototype	prototype
JavaScript/Reference/Global_Objects/TypeError	TypeError
JavaScript/Reference/Global_Objects/TypeError/constructor	constructor
JavaScript/Reference/Global_Objects/TypeError/name	name
JavaScript/Reference/Global_Objects/TypeError/prototype	prototype
JavaScript/Reference/Global_Objects/URIError	URIError
JavaScript/Reference/Global_Objects/URIError/constructor	constructor
JavaScript/Reference/Global_Objects/URIError/name	name
JavaScript/Reference/Global_Objects/URIError/prototype	prototype
JavaScript/Reference/Global_Objects/decodeURI	decodeURI
JavaScript/Reference/Global_Objects/decodeURIComponent	decodeURIComponent
JavaScript/Reference/Global_Objects/encodeURI	encodeURI
JavaScript/Reference/Global_Objects/encodeURIComponent	encodeURIComponent
JavaScript/Reference/Global_Objects/eval	eval
JavaScript/Reference/Global_Objects/isFinite	isFinite
JavaScript/Reference/Global_Objects/isNaN	isNaN
JavaScript/Reference/Global_Objects/parseFloat	parseFloat
JavaScript/Reference/Global_Objects/parseInt	parseInt
JavaScript/Reference/Global_Objects/undefined	undefined
DOM/document	document
DOM/document.URL	document.URL
DOM/document.activeElement	document.activeElement
DOM/document.adoptNode	document.adoptNode
DOM/document.alinkColor	document.alinkColor
DOM/document.anchors	document.anchors
DOM/document.applets	document.applets
DOM/document.async	document.async
DOM/document.baseURIObject	document.baseURIObject
DOM/document.bgColor	document.bgColor
DOM/document.body	document.body
DOM/document.characterSet	document.characterSet
DOM/document.clear	document.clear
DOM/document.close	document.close
DOM/document.compatMode	document.compatMode
DOM/document.contentType	document.contentType
DOM/document.cookie	document.cookie
DOM/document.createAttribute	document.createAttribute
DOM/document.createCDATASection	document.createCDATASection
DOM/document.createComment	document.createComment
DOM/document.createDocumentFragment	document.createDocumentFragment
DOM/document.createElement	document.createElement
DOM/document.createElementNS	document.createElementNS
DOM/document.createEntityReference	document.createEntityReference
DOM/document.createEvent	document.createEvent
DOM/document.createExpression	document.createExpression
DOM/document.createNSResolver	document.createNSResolver
DOM/document.createProcessingInstruction	document.createProcessingInstruction
DOM/document.createRange	document.createRange
DOM/document.createTextNode	document.createTextNode
DOM/document.createTreeWalker	document.createTreeWalker
DOM/document.currentScript	document.currentScript
DOM/document.defaultView	document.defaultView
DOM/document.designMode	document.designMode
DOM/document.doctype	document.doctype
DOM/document.documentElement	document.documentElement
DOM/document.documentURI	document.documentURI
DOM/document.documentURIObject	document.documentURIObject
DOM/document.domain	document.domain
DOM/document.elementFromPoint	document.elementFromPoint
DOM/document.embeds	document.embeds
DOM/document.enableStyleSheetsForSet	document.enableStyleSheetsForSet
DOM/document.evaluate	document.evaluate
DOM/document.execCommand	document.execCommand
DOM/document.fgColor	document.fgColor
DOM/document.firstChild	document.firstChild
DOM/document.forms	document.forms
DOM/document.getBoxObjectFor	document.getBoxObjectFor
DOM/document.getElementById	document.getElementById
DOM/document.getElementsByClassName	document.getElementsByClassName
DOM/document.getElementsByName	document.getElementsByName
DOM/document.getElementsByTagName	document.getElementsByTagName
DOM/document.getElementsByTagNameNS	document.getElementsByTagNameNS
DOM/document.hasFocus	document.hasFocus
DOM/document.height	document.height
DOM/document.images	document.images
DOM/document.implementation	document.implementation
DOM/document.importNode	document.importNode
DOM/document.inputEncoding	document.inputEncoding
DOM/document.lastModified	document.lastModified
DOM/document.lastStyleSheetSet	document.lastStyleSheetSet
DOM/document.linkColor	document.linkColor
DOM/document.links	document.links
DOM/document.load	document.load
DOM/document.loadOverlay	document.loadOverlay
DOM/document.location	document.location
DOM/document.mozSetImageElement	document.mozSetImageElement
DOM/document.namespaceURI	document.namespaceURI
DOM/document.nodePrincipal	document.nodePrincipal
DOM/document.onafterscriptexecute	document.onafterscriptexecute
DOM/document.onbeforescriptexecute	document.onbeforescriptexecute
DOM/document.onreadystatechange	document.onreadystatechange
DOM/document.open	document.open
DOM/document.plugins	document.plugins
DOM/document.popupNode	document.popupNode
DOM/document.preferredStyleSheetSet	document.preferredStyleSheetSet
DOM/document.readyState	document.readyState
DOM/document.referrer	document.referrer
DOM/document.releaseCapture	document.releaseCapture
DOM/document.selectedStyleSheetSet	document.selectedStyleSheetSet
DOM/document.styleSheetSets	document.styleSheetSets
DOM/document.styleSheets	document.styleSheets
DOM/document.textContent	document.textContent
DOM/document.title	document.title
DOM/document.tooltipNode	document.tooltipNode
DOM/document.vlinkColor	document.vlinkColor
DOM/document.width	document.width
DOM/document.write	document.write
DOM/document.writeln	document.writeln
DOM/document.xmlVersion	document.xmlVersion
DOM/element	element
DOM/element.addEventListener	element.addEventListener
DOM/element.baseURIObject	element.baseURIObject
DOM/element.blur	element.blur
DOM/element.classList	element.classList
DOM/element.className	element.className
DOM/element.click	element.click
DOM/element.clientHeight	element.clientHeight
DOM/element.clientLeft	element.clientLeft
DOM/element.clientTop	element.clientTop
DOM/element.clientWidth	element.clientWidth
DOM/element.dir	element.dir
DOM/element.dispatchEvent	element.dispatchEvent
DOM/element.focus	element.focus
DOM/element.getAttribute	element.getAttribute
DOM/element.getAttributeNS	element.getAttributeNS
DOM/element.getAttributeNode	element.getAttributeNode
DOM/element.getAttributeNodeNS	element.getAttributeNodeNS
DOM/element.getBoundingClientRect	element.getBoundingClientRect
DOM/element.getClientRects	element.getClientRects
DOM/element.getElementsByTagName	element.getElementsByTagName
DOM/element.getElementsByTagNameNS	element.getElementsByTagNameNS
DOM/element.hasAttribute	element.hasAttribute
DOM/element.hasAttributeNS	element.hasAttributeNS
DOM/element.id	element.id
DOM/element.innerHTML	element.innerHTML
DOM/element.item	element.item
DOM/element.lang	element.lang
DOM/element.length	element.length
DOM/element.name	element.name
DOM/element.offsetHeight	element.offsetHeight
DOM/element.offsetLeft	element.offsetLeft
DOM/element.offsetParent	element.offsetParent
DOM/element.offsetTop	element.offsetTop
DOM/element.offsetWidth	element.offsetWidth
DOM/element.onblur	element.onblur
DOM/element.onchange	element.onchange
DOM/element.onclick	element.onclick
DOM/element.oncopy	element.oncopy
DOM/element.oncut	element.oncut
DOM/element.ondblclick	element.ondblclick
DOM/element.onfocus	element.onfocus
DOM/element.onkeydown	element.onkeydown
DOM/element.onkeypress	element.onkeypress
DOM/element.onkeyup	element.onkeyup
DOM/element.onmousedown	element.onmousedown
DOM/element.onmousemove	element.onmousemove
DOM/element.onmouseout	element.onmouseout
DOM/element.onmouseover	element.onmouseover
DOM/element.onmouseup	element.onmouseup
DOM/element.onpaste	element.onpaste
DOM/element.onresize	element.onresize
DOM/element.onscroll	element.onscroll
DOM/element.removeAttribute	element.removeAttribute
DOM/element.removeAttributeNS	element.removeAttributeNS
DOM/element.removeAttributeNode	element.removeAttributeNode
DOM/element.removeEventListener	element.removeEventListener
DOM/element.scrollHeight	element.scrollHeight
DOM/element.scrollIntoView	element.scrollIntoView
DOM/element.scrollLeft	element.scrollLeft
DOM/element.scrollTop	element.scrollTop
DOM/element.scrollWidth	element.scrollWidth
DOM/element.setAttribute	element.setAttribute
DOM/element.setAttributeNS	element.setAttributeNS
DOM/element.setAttributeNode	element.setAttributeNode
DOM/element.setAttributeNodeNS	element.setAttributeNodeNS
DOM/element.setCapture	element.setCapture
DOM/element.style	element.style
DOM/element.supports	element.supports
DOM/element.tabIndex	element.tabIndex
DOM/element.tagName	element.tagName
DOM/element.title	element.title
DOM/event	event
DOM/event.altKey	event.altKey
DOM/event.bubbles	event.bubbles
DOM/event.button	event.button
DOM/event.cancelBubble	event.cancelBubble
DOM/event.cancelable	event.cancelable
DOM/event.charCode	event.charCode
DOM/event.clientX	event.clientX
DOM/event.clientY	event.clientY
DOM/event.ctrlKey	event.ctrlKey
DOM/event.currentTarget	event.currentTarget
DOM/event.detail	event.detail
DOM/event.eventPhase	event.eventPhase
DOM/event.explicitOriginalTarget	event.explicitOriginalTarget
DOM/event.initEvent	event.initEvent
DOM/event.initKeyEvent	event.initKeyEvent
DOM/event.initMouseEvent	event.initMouseEvent
DOM/event.initUIEvent	event.initUIEvent
DOM/event.isChar	event.isChar
DOM/event.keyCode	event.keyCode
DOM/event.layerX	event.layerX
DOM/event.layerY	event.layerY
DOM/event.metaKey	event.metaKey
DOM/event.mozInputSource	event.mozInputSource
DOM/event.originalTarget	event.originalTarget
DOM/event.pageX	event.pageX
DOM/event.pageY	event.pageY
DOM/event.preventDefault	event.preventDefault
DOM/event.relatedTarget	event.relatedTarget
DOM/event.screenX	event.screenX
DOM/event.screenY	event.screenY
DOM/event.shiftKey	event.shiftKey
DOM/event.stopPropagation	event.stopPropagation
DOM/event.target	event.target
DOM/event.timeStamp	event.timeStamp
DOM/event.type	event.type
DOM/event.view	event.view
DOM/event.which	event.which
DOM/event/Comparison_of_Event_Targets	Comparison of Event Targets
DOM/event/StorageEvent	StorageEvent
DOM/form.acceptCharset	form.acceptCharset
DOM/form.action	form.action
DOM/form.elements	form.elements
DOM/form.encoding	form.encoding
DOM/form.enctype	form.enctype
DOM/form.length	form.length
DOM/form.method	form.method
DOM/form.name	form.name
DOM/form.reset	form.reset
DOM/form.submit	form.submit
DOM/form.target	form.target
DOM/html.version	html.version
DOM/range	range
DOM/range.cloneContents	range.cloneContents
DOM/range.cloneRange	range.cloneRange
DOM/range.collapse	range.collapse
DOM/range.collapsed	range.collapsed
DOM/range.commonAncestorContainer	range.commonAncestorContainer
DOM/range.compareBoundaryPoints	range.compareBoundaryPoints
DOM/range.compareNode	range.compareNode
DOM/range.comparePoint	range.comparePoint
DOM/range.createContextualFragment	range.createContextualFragment
DOM/range.deleteContents	range.deleteContents
DOM/range.detach	range.detach
DOM/range.endContainer	range.endContainer
DOM/range.endOffset	range.endOffset
DOM/range.extractContents	range.extractContents
DOM/range.getBoundingClientRect	range.getBoundingClientRect
DOM/range.getClientRects	range.getClientRects
DOM/range.insertNode	range.insertNode
DOM/range.intersectsNode	range.intersectsNode
DOM/range.isPointInRange	range.isPointInRange
DOM/range.selectNode	range.selectNode
DOM/range.selectNodeContents	range.selectNodeContents
DOM/range.setEnd	range.setEnd
DOM/range.setEndAfter	range.setEndAfter
DOM/range.setEndBefore	range.setEndBefore
DOM/range.setStart	range.setStart
DOM/range.setStartAfter	range.setStartAfter
DOM/range.setStartBefore	range.setStartBefore
DOM/range.startContainer	range.startContainer
DOM/range.startOffset	range.startOffset
DOM/range.surroundContents	range.surroundContents
DOM/range.toString	range.toString
DOM/select.type	select.type
DOM/style.media	style.media
DOM/style.type	style.type
DOM/stylesheet	Stylesheet object
DOM/stylesheet.cssRules	stylesheet.cssRules
DOM/stylesheet.deleteRule	stylesheet.deleteRule
DOM/stylesheet.disabled	stylesheet.disabled
DOM/stylesheet.href	stylesheet.href
DOM/stylesheet.insertRule	stylesheet.insertRule
DOM/stylesheet.media	stylesheet.media
DOM/stylesheet.ownerNode	stylesheet.ownerNode
DOM/stylesheet.ownerRule	stylesheet.ownerRule
DOM/stylesheet.parentStyleSheet	stylesheet.parentStyleSheet
DOM/stylesheet.title	stylesheet.title
DOM/stylesheet.type	stylesheet.type
DOM/table.align	table.align
DOM/table.bgColor	table.bgColor
DOM/table.border	table.border
DOM/table.caption	table.caption
DOM/table.cellPadding	table.cellPadding
DOM/table.cellSpacing	table.cellSpacing
DOM/table.createCaption	table.createCaption
DOM/table.createTFoot	table.createTFoot
DOM/table.createTHead	table.createTHead
DOM/table.deleteCaption	table.deleteCaption
DOM/table.deleteRow	table.deleteRow
DOM/table.deleteTFoot	table.deleteTFoot
DOM/table.deleteTHead	table.deleteTHead
DOM/table.frame	table.frame
DOM/table.insertRow	table.insertRow
DOM/table.rows	table.rows
DOM/table.rules	table.rules
DOM/table.summary	table.summary
DOM/table.tBodies	table.tBodies
DOM/table.tFoot	table.tFoot
DOM/table.tHead	table.tHead
DOM/table.width	table.width
DOM/tableRow.insertCell	tableRow.insertCell
DOM/treeWalker	treeWalker
DOM/treeWalker.filter	treeWalker.filter
DOM/treeWalker.root	treeWalker.root
DOM/treeWalker.whatToShow	treeWalker.whatToShow
DOM/window	window
DOM/window.URL	window.URL
DOM/window.URL.createObjectURL	window.URL.createObjectURL
DOM/window.URL.revokeObjectURL	window.URL.revokeObjectURL
DOM/window.alert	window.alert
DOM/window.applicationCache	window.applicationCache
DOM/window.arguments	window.arguments
DOM/window.atob	window.atob
DOM/window.back	window.back
DOM/window.blur	window.blur
DOM/window.btoa	window.btoa
DOM/window.captureEvents	window.captureEvents
DOM/window.clearInterval	window.clearInterval
DOM/window.clearTimeout	window.clearTimeout
DOM/window.close	window.close
DOM/window.closed	window.closed
DOM/window.confirm	window.confirm
DOM/window.content	window.content
DOM/window.controllers	window.controllers
DOM/window.crypto	window.crypto
DOM/window.defaultStatus	window.defaultStatus
DOM/window.dialogArguments	window.dialogArguments
DOM/window.directories	window.directories
DOM/window.document	window.document
DOM/window.dump	window.dump
DOM/window.escape	window.escape
DOM/window.find	window.find
DOM/window.focus	window.focus
DOM/window.forward	window.forward
DOM/window.frameElement	window.frameElement
DOM/window.frames	window.frames
DOM/window.fullScreen	window.fullScreen
DOM/window.getAttention	window.getAttention
DOM/window.getComputedStyle	window.getComputedStyle
DOM/window.getSelection	window.getSelection
DOM/window.history	window.history
DOM/window.home	window.home
DOM/window.importDialog	window.importDialog
DOM/window.innerHeight	window.innerHeight
DOM/window.innerWidth	window.innerWidth
DOM/window.length	window.length
DOM/window.location	window.location
DOM/window.locationbar	window.locationbar
DOM/window.menubar	window.menubar
DOM/window.messageManager	window.messageManager
DOM/window.minimize	window.minimize
DOM/window.moveBy	window.moveBy
DOM/window.moveTo	window.moveTo
DOM/window.mozAnimationStartTime	window.mozAnimationStartTime
DOM/window.mozInnerScreenX	window.mozInnerScreenX
DOM/window.mozInnerScreenY	window.mozInnerScreenY
DOM/window.mozPaintCount	window.mozPaintCount
DOM/window.mozRequestAnimationFrame	window.mozRequestAnimationFrame
DOM/window.name	window.name
DOM/window.navigator	window.navigator
DOM/window.navigator.appCodeName	window.navigator.appCodeName
DOM/window.navigator.appName	window.navigator.appName
DOM/window.navigator.appVersion	window.navigator.appVersion
DOM/window.navigator.buildID	window.navigator.buildID
DOM/window.navigator.cookieEnabled	window.navigator.cookieEnabled
DOM/window.navigator.javaEnabled	window.navigator.javaEnabled
DOM/window.navigator.language	window.navigator.language
DOM/window.navigator.mimeTypes	window.navigator.mimeTypes
DOM/window.navigator.mozIsLocallyAvailable	window.navigator.mozIsLocallyAvailable
DOM/window.navigator.onLine	window.navigator.onLine
DOM/window.navigator.oscpu	window.navigator.oscpu
DOM/window.navigator.platform	window.navigator.platform
DOM/window.navigator.plugins	window.navigator.plugins
DOM/window.navigator.product	window.navigator.product
DOM/window.navigator.productSub	window.navigator.productSub
DOM/window.navigator.registerContentHandler	window.navigator.registerContentHandler
DOM/window.navigator.registerProtocolHandler	window.navigator.registerProtocolHandler
DOM/window.navigator.userAgent	window.navigator.userAgent
DOM/window.navigator.vendor	window.navigator.vendor
DOM/window.navigator.vendorSub	window.navigator.vendorSub
DOM/window.onabort	window.onabort
DOM/window.onbeforeunload	window.onbeforeunload
DOM/window.onblur	window.onblur
DOM/window.onchange	window.onchange
DOM/window.onclick	window.onclick
DOM/window.onclose	window.onclose
DOM/window.oncontextmenu	window.oncontextmenu
DOM/window.ondragdrop	window.ondragdrop
DOM/window.onerror	window.onerror
DOM/window.onfocus	window.onfocus
DOM/window.onhashchange	window.onhashchange
DOM/window.onkeydown	window.onkeydown
DOM/window.onkeypress	window.onkeypress
DOM/window.onkeyup	window.onkeyup
DOM/window.onload	window.onload
DOM/window.onmousedown	window.onmousedown
DOM/window.onmousemove	window.onmousemove
DOM/window.onmouseout	window.onmouseout
DOM/window.onmouseover	window.onmouseover
DOM/window.onmouseup	window.onmouseup
DOM/window.onmozbeforepaint	window.onmozbeforepaint
DOM/window.onmozorientation	window.onmozorientation
DOM/window.onpaint	window.onpaint
DOM/window.onpopstate	window.onpopstate
DOM/window.onreset	window.onreset
DOM/window.onresize	window.onresize
DOM/window.onscroll	window.onscroll
DOM/window.onselect	window.onselect
DOM/window.onsubmit	window.onsubmit
DOM/window.onunload	window.onunload
DOM/window.open	window.open
DOM/window.openDialog	window.openDialog
DOM/window.opener	window.opener
DOM/window.outerHeight	window.outerHeight
DOM/window.outerWidth	window.outerWidth
DOM/window.parent	window.parent
DOM/window.personalbar	window.personalbar
DOM/window.pkcs11	window.pkcs11
DOM/window.postMessage	window.postMessage
DOM/window.print	window.print
DOM/window.prompt	window.prompt
DOM/window.prompter	window.prompter
DOM/window.releaseEvents	window.releaseEvents
DOM/window.resizeBy	window.resizeBy
DOM/window.resizeTo	window.resizeTo
DOM/window.restore	window.restore
DOM/window.screen	window.screen
DOM/window.screen.availHeight	window.screen.availHeight
DOM/window.screen.availLeft	window.screen.availLeft
DOM/window.screen.availTop	window.screen.availTop
DOM/window.screen.availWidth	window.screen.availWidth
DOM/window.screen.colorDepth	window.screen.colorDepth
DOM/window.screen.height	window.screen.height
DOM/window.screen.left	window.screen.left
DOM/window.screen.pixelDepth	window.screen.pixelDepth
DOM/window.screen.top	window.screen.top
DOM/window.screen.width	window.screen.width
DOM/window.screenX	window.screenX
DOM/window.screenY	window.screenY
DOM/window.scroll	window.scroll
DOM/window.scrollBy	window.scrollBy
DOM/window.scrollByLines	window.scrollByLines
DOM/window.scrollByPages	window.scrollByPages
DOM/window.scrollMaxX	window.scrollMaxX
DOM/window.scrollMaxY	window.scrollMaxY
DOM/window.scrollTo	window.scrollTo
DOM/window.scrollX	window.scrollX
DOM/window.scrollY	window.scrollY
DOM/window.scrollbars	window.scrollbars
DOM/window.self	window.self
DOM/window.setCursor	window.setCursor
DOM/window.setInterval	window.setInterval
DOM/window.setTimeout	window.setTimeout
DOM/window.showModalDialog	window.showModalDialog
DOM/window.sidebar	window.sidebar
DOM/window.sizeToContent	window.sizeToContent
DOM/window.status	window.status
DOM/window.statusbar	window.statusbar
DOM/window.stop	window.stop
DOM/window.toolbar	window.toolbar
DOM/window.top	window.top
DOM/window.unescape	window.unescape
DOM/window.updateCommands	window.updateCommands
DOM/window.window	window.window
